################################################
#           #                    #             #
#           #                    #             #
#                                #             #
#           #                    #             #
#           #############  #######             #
#           #                                  #
#############                                  #
#           #                                  #
#           #                   #######  #######
#           #                   #              #
#                               #              #
#           ######  #############              #
#           #                   #              #
#           #                   #              #
################################################
